0 0 0 0 0 0 0 0 0 0 0 0 0 0 0
0 0 0 0 0 0 0 0 0 0 0 0 0 0 0
0 C 0 0 C 0 0 0 0 0 0 0 0 C 0
0 0 0 0 0 0 0 0 0 0 0 0 0 0 0
0 0 0 0 C 0 0 0 C 0 0 0 0 0 0
0 0 0 0 0 0 0 0 0 0 0 0 0 0 0
0 C C 0 0 0 0 0 C 0 0 C 0 0 0
0 0 0 0 0 0 0 0 0 0 C 0 0 C 0
0 0 0 0 C 0 0 0 C 0 0 0 0 0 0
0 0 0 0 0 0 0 0 0 0 0 0 0 0 0