b B B b w W W W W W W W W W w
b B B b W d D D D D D D D d W
W W W W w D G G G G G G G D W
G G G G T D G d D D D d T D W
G G G d D d G D G G G D G D W
w W w D G G G D T C G D G D W
W T W D G G G d D d G D G D W
w W w D G G T G G G G D G D W
G G G d D D D D D D D d T D W
W W W W W W W W W W W W w D W
b B B B B B B B B B B B B S b
B X X X X X X X X X X X X X B
B X X X X X X X X X X X X X B