b B B b G G G G G G G G G G G
b B B b G G G G G G G C G G G
G d D D d G G G G G G D G w W
G D G T D G G G G G G D T W G
G D G G D G G G G G G D G W G
G D G G D G G G G T G D G W G
T d d G D G G G d D D d T W G
G G D G D T G G D G w W W w G
G G D G d D D D d G W G G G G
G G D G G G G G G G W G G G G
b B S B B B B B B B B B B B b
B X X X X X X X X X X X X X B
B X X X X X X X X X X X X X B